0:9  0:9  0:9  0:9  0:9  0:9  0:9  0:9  0:9  0:9  0:9  0:9  0:9  0:9  0:9  0:9  0:9  0:9  0:9  0:9  0:9  0:9  0:9  0:9  0:9  0:9  0:9  0:9  0:9  
0:9  0:9  0:9  0:9  0:9  0:9  0:9  0:9  0:9  0:9  0:9  0:2  0:2  0:9  0:9  0:9  0:9  0:9  0:9  0:2  0:9  0:9  0:9  0:9  0:9  0:9  0:9  0:9  0:9  
0:9  0:9  0:9  0:9  0:9  0:9  0:9  0:9  0:9  0:9  0:9  0:6  0:6  0:9  0:9  0:9  0:9  0:9  0:9  0:6  0:9  0:9  0:9  0:9  0:9  0:9  0:9  0:9  0:9  
0:9  0:9  0:9  0:9  0:9  0:9  0:9  0:9  0:9  0:9  0:9  0:9  0:9  0:9  0:9  0:9  0:9  0:9  0:9  0:9  0:9  0:9  0:9  0:9  0:9  0:9  0:9  0:9  0:9  
0:9  0:9  0:9  0:9  0:9  0:9  0:9  0:9  0:9  0:9  0:9  0:9  0:9  0:1  0:1  0:9  0:9  0:9  0:9  0:9  0:9  0:9  0:9  0:9  0:9  0:9  0:9  0:9  0:9  
0:9  0:9  0:9  0:9  0:9  0:9  0:9  0:9  0:9  0:9  0:9  0:9  0:0  0:0  0:0  0:0  0:9  0:9  0:9  0:9  0:9  0:9  0:9  0:9  0:9  0:9  0:9  0:9  0:9  
0:9  0:9  0:9  0:9  0:9  0:9  0:9  0:9  0:9  0:9  0:9  0:9  0:0  0:9  0:9  0:0  0:9  0:9  0:9  0:9  0:9  0:9  0:9  0:9  0:9  0:9  0:9  0:9  0:9  
0:9  0:9  0:9  0:9  0:9  0:9  0:9  0:9  0:9  0:9  0:9  0:9  0:0  0:9  0:9  0:0  0:9  0:9  0:9  0:9  0:9  0:9  0:9  0:9  0:9  0:9  0:9  0:9  0:9  
0:9  0:9  0:9  0:0  0:0  0:0  0:0  0:0  0:0  0:0  0:0  0:0  0:0  0:6  0:6  0:0  0:0  0:0  0:0  0:0  0:0  0:0  0:9  0:9  0:9  0:9  0:9  0:9  0:9  
0:9  0:9  0:9  0:0  0:9  0:9  0:9  0:9  0:9  0:9  0:9  0:9  0:9  0:9  0:9  0:6  0:9  0:9  0:9  0:9  0:9  0:9  0:0  0:9  0:9  0:9  0:9  0:9  0:9  
0:9  0:9  0:9  0:0  0:9  0:9  0:9  0:0  0:0  0:0  0:0  0:9  0:9  0:9  0:9  0:0  0:0  0:0  0:0  0:9  0:9  0:9  0:0  0:9  0:9  0:9  0:9  0:9  0:9  
0:9  0:9  0:9  0:0  0:9  0:9  0:9  0:0  0:6  0:6  0:0  0:9  0:9  0:9  0:9  0:0  0:6  0:6  0:0  0:9  0:9  0:9  0:0  0:9  0:9  0:9  0:9  0:9  0:9  
0:9  0:9  0:9  0:0  0:9  0:9  0:3  0:0  0:0  0:0  0:0  0:9  0:9  0:9  0:3  0:0  0:0  0:0  0:0  0:9  0:9  0:9  0:0  0:9  0:9  0:9  0:9  0:9  0:9  
0:9  0:9  0:9  0:0  0:9  0:9  0:9  0:9  0:9  0:9  0:9  0:9  0:9  0:9  0:9  0:9  0:9  0:9  0:9  0:9  0:9  0:9  0:0  0:9  0:9  0:9  0:9  0:9  0:9  
0:9  0:9  0:9  0:0  0:9  0:9  0:9  0:9  0:9  0:9  0:9  0:9  0:9  0:9  0:9  0:9  0:9  0:9  0:9  0:9  0:9  0:9  0:0  0:9  0:9  0:9  0:9  0:9  0:9  
0:9  0:9  0:9  0:0  0:9  0:9  0:9  0:9  0:9  0:9  0:9  0:9  0:9  0:0  0:0  0:0  0:0  0:0  0:0  0:9  0:9  0:9  0:0  0:9  0:9  0:9  0:9  0:9  0:9  
0:9  0:9  0:9  0:0  0:9  0:9  0:9  0:0  0:0  0:0  0:3  0:9  0:9  0:0  0:6  0:6  0:6  0:6  0:0  0:9  0:9  0:9  0:0  0:9  0:9  0:9  0:9  0:9  0:9  
0:9  0:9  0:9  0:0  0:9  0:9  0:9  0:9  0:9  0:2  0:2  0:9  0:9  0:0  0:9  0:9  0:9  0:9  0:0  0:9  0:9  0:9  0:0  0:9  0:9  0:9  0:9  0:9  0:9  
0:9  0:9  0:9  0:0  0:9  0:9  0:9  0:9  0:9  0:9  0:9  0:9  0:9  0:0  0:0  0:0  0:0  0:0  0:0  0:9  0:9  0:9  0:0  0:9  0:9  0:9  0:9  0:9  0:9  
0:9  0:9  0:9  0:0  0:9  0:9  0:9  0:9  0:9  0:9  0:9  0:9  0:9  0:9  0:9  0:9  0:9  0:9  0:9  0:9  0:9  0:9  0:0  0:9  0:9  0:9  0:9  0:9  0:9  
0:9  0:9  0:9  0:0  0:9  0:9  0:9  0:9  0:9  0:9  0:9  0:9  0:9  0:0  0:0  0:0  0:3  0:0  0:0  0:9  0:9  0:9  0:0  0:9  0:9  0:9  0:9  0:9  0:9  
0:9  0:9  0:9  0:0  0:9  0:9  0:9  0:4  0:4  0:4  0:4  0:9  0:9  0:9  0:9  0:9  0:9  0:9  0:9  0:9  0:9  0:9  0:0  0:9  0:9  0:9  0:9  0:9  0:9  
0:9  0:9  0:9  0:0  0:9  0:9  0:9  0:4  0:4  0:4  0:4  0:9  0:9  0:9  0:9  0:9  0:9  0:9  0:9  0:9  0:9  0:9  0:0  0:9  0:9  0:9  0:9  0:9  0:9  
0:9  0:9  0:9  0:0  0:9  0:9  0:9  0:4  0:4  0:4  0:4  0:9  0:9  0:9  0:9  0:9  0:9  0:9  0:9  0:9  0:9  0:9  0:0  0:9  0:9  0:9  0:9  0:9  0:9  
0:9  0:9  0:9  0:9  0:0  0:9  0:9  0:4  0:4  0:4  0:4  0:0  0:0  0:0  0:0  0:0  0:0  0:0  0:0  0:0  0:0  0:0  0:9  0:9  0:9  0:9  0:9  0:9  0:9  
0:9  0:9  0:9  0:9  0:9  0:0  0:0  0:4  0:4  0:4  0:4  0:9  0:9  0:9  0:9  0:9  0:9  0:9  0:9  0:9  0:9  0:9  0:9  0:9  0:9  0:9  0:9  0:9  0:9  
0:9  0:9  0:9  0:9  0:9  0:9  0:9  0:4  0:4  0:4  0:4  0:9  0:9  0:9  0:9  0:9  0:9  0:9  0:9  0:9  0:9  0:9  0:9  0:9  0:9  0:9  0:9  0:9  0:9  
0:9  0:9  0:9  0:9  0:9  0:9  0:9  0:4  0:4  0:4  0:4  0:9  0:9  0:9  0:9  0:9  0:9  0:9  0:9  0:9  0:9  0:9  0:9  0:9  0:9  0:9  0:9  0:9  0:9  
0:9  0:9  0:9  0:9  0:9  0:9  0:9  0:4  0:4  0:4  0:4  0:9  0:9  0:9  0:9  0:9  0:9  0:9  0:9  0:9  0:9  0:9  0:9  0:9  0:9  0:9  0:9  0:9  0:9  
0:9  0:9  0:9  0:9  0:9  0:9  0:9  0:9  0:9  0:9  0:9  0:9  0:9  0:9  0:9  0:9  0:9  0:9  0:9  0:9  0:9  0:9  0:9  0:9  0:9  0:9  0:9  0:9  0:9  
0:9  0:9  0:9  0:9  0:9  0:9  0:9  0:9  0:9  0:9  0:9  0:9  0:9  0:9  0:9  0:9  0:9  0:9  0:9  0:9  0:9  0:9  0:9  0:9  0:9  0:9  0:9  0:9  0:9  
0:9  0:9  0:9  0:9  0:9  0:9  0:9  0:9  0:9  0:9  0:9  0:9  0:9  0:9  0:9  0:9  0:9  0:9  0:9  0:9  0:9  0:9  0:9  0:9  0:9  0:9  0:9  0:9  0:9  
0:9  0:9  0:9  0:9  0:9  0:9  0:9  0:9  0:9  0:9  0:9  0:9  0:9  0:9  0:9  0:9  0:9  0:9  0:9  0:9  0:9  0:9  0:9  0:9  0:9  0:9  0:9  0:9  0:9  
0:9  0:9  0:9  0:9  0:9  0:9  0:9  0:9  0:9  0:9  0:9  0:9  0:9  0:9  0:9  0:9  0:9  0:9  0:9  0:9  0:9  0:9  0:9  0:9  0:9  0:9  0:9  0:9  0:9  
0:9  0:9  0:9  0:9  0:9  0:9  0:9  0:9  0:9  0:9  0:9  0:9  0:9  0:9  0:9  0:9  0:9  0:9  0:9  0:9  0:9  0:9  0:9  0:9  0:9  0:9  0:9  0:9  0:9  
