0:9  0:9  0:9  0:9  0:9  0:9  0:9  0:9  0:9  4:5  4:5  4:5  4:5  0:9  0:9  0:9  0:9  4:5  4:5  4:5  0:9  0:9  0:9  0:9  0:9  0:9  0:9  0:9  0:9  
0:9  0:9  0:9  0:9  0:9  0:9  0:9  0:9  0:9  4:5  4:5  0:9  0:9  0:9  0:9  4:5  4:5  4:5  4:5  0:9  0:9  0:9  0:9  0:9  0:9  0:9  0:9  0:9  0:9  
0:9  0:9  0:9  0:9  0:9  0:9  0:9  0:9  0:9  4:5  4:5  0:9  0:9  0:9  0:9  4:5  4:5  4:5  4:5  0:9  0:9  0:9  0:9  0:9  0:9  0:9  0:9  0:9  0:9  
0:9  0:9  0:9  0:9  0:9  0:9  0:9  0:9  0:9  1:7  1:7  1:7  1:7  4:5  4:5  1:7  1:7  1:7  1:7  1:7  0:9  0:9  0:9  0:9  0:9  0:9  0:9  0:9  0:9  
0:9  0:9  0:9  0:9  0:9  0:9  0:9  0:9  0:9  0:9  0:9  0:9  1:7  4:5  4:5  1:7  0:9  0:9  0:9  0:9  0:9  0:9  0:9  0:9  0:9  0:9  0:9  0:9  0:9  
0:9  0:9  0:9  0:9  0:9  0:9  1:6  0:9  0:9  0:9  0:9  0:9  1:7  4:5  4:5  1:7  0:9  0:9  0:9  0:9  0:9  1:6  0:9  0:9  0:9  0:9  0:9  0:9  0:9  
0:9  0:9  0:9  0:9  0:9  0:9  1:6  0:9  0:9  0:9  0:9  0:9  1:7  4:5  4:5  1:7  0:9  0:9  0:9  0:9  0:9  1:6  0:9  0:9  0:9  0:9  0:9  0:9  0:9  
0:9  0:9  0:9  0:9  0:9  0:9  1:7  0:9  0:9  0:9  0:9  0:9  1:7  4:5  4:5  1:7  0:9  0:9  0:9  0:9  0:9  1:7  0:9  0:9  0:9  0:9  0:9  0:9  0:9  
0:9  0:9  0:9  1:7  1:7  1:7  1:7  1:7  1:7  1:7  1:7  1:7  1:7  4:5  4:5  1:7  1:7  1:7  1:7  1:7  1:7  1:7  1:7  0:9  0:9  0:9  0:9  0:9  0:9  
0:9  0:9  0:9  1:7  0:9  0:9  0:9  0:9  0:9  0:9  0:9  0:9  0:9  0:9  0:9  0:9  0:9  0:9  0:9  0:9  0:9  0:9  1:7  0:9  0:9  0:9  0:9  0:9  0:9  
0:9  0:9  0:9  1:7  0:9  0:9  0:9  4:0  4:1  4:1  4:3  0:9  0:9  0:9  0:9  4:0  4:1  4:2  4:3  0:9  0:9  0:9  1:7  0:9  0:9  0:9  0:9  0:9  0:9  
0:9  0:9  0:9  1:7  0:9  0:9  0:9  5:0  5:1  5:2  5:3  0:9  0:9  0:9  0:9  5:0  5:1  5:2  5:3  0:9  0:9  0:9  1:7  0:9  0:9  0:9  0:9  0:9  0:9  
0:9  0:9  0:9  1:7  0:9  0:9  1:9  6:0  6:1  6:2  6:3  0:9  0:9  0:9  1:9  6:0  6:1  6:2  6:3  0:9  0:9  0:9  1:7  0:9  0:9  0:9  0:9  0:9  0:9  
0:9  0:9  0:9  1:7  0:9  0:9  0:9  0:9  0:9  0:9  0:9  0:9  0:9  0:9  0:9  0:9  0:9  0:9  0:9  0:9  0:9  0:9  1:7  0:9  0:9  0:9  0:9  0:9  0:9  
0:9  0:9  0:9  1:7  0:9  0:9  0:9  0:9  0:9  0:9  0:9  0:9  0:9  0:9  0:9  0:9  0:9  0:9  0:9  0:9  0:9  0:9  1:7  0:9  0:9  0:9  0:9  0:9  0:9  
0:9  0:9  0:9  1:7  0:9  0:9  0:9  0:9  0:9  0:9  0:9  0:9  0:9  0:0  0:1  0:2  0:3  0:4  0:5  0:9  0:9  0:9  1:7  0:9  0:9  0:9  0:9  0:9  0:9  
0:9  0:9  0:9  1:7  0:9  0:9  0:9  1:8  1:8  1:8  1:9  0:9  0:9  1:0  1:1  1:2  1:3  1:4  1:5  0:9  0:9  0:9  1:7  0:9  0:9  0:9  0:9  0:9  0:9  
0:9  0:9  0:9  1:7  0:9  0:9  0:9  0:9  0:9  0:9  0:9  0:9  0:9  2:0  2:1  2:2  2:3  2:4  2:5  0:9  0:9  0:9  1:7  0:9  0:9  0:9  0:9  0:9  0:9  
0:9  0:9  0:9  1:7  0:9  0:9  0:9  0:9  0:9  0:9  0:9  0:9  0:9  3:0  3:1  3:2  3:3  3:4  3:5  0:9  0:9  0:9  1:7  0:9  0:9  0:9  0:9  0:9  0:9  
0:9  0:9  0:9  1:7  0:9  0:9  0:9  0:9  0:9  0:9  0:9  0:9  0:9  0:9  0:9  0:9  0:9  0:9  0:9  0:9  0:9  0:9  1:7  0:9  0:9  0:9  0:9  0:9  0:9  
0:9  0:9  0:9  1:7  0:9  0:9  0:9  0:9  0:9  0:9  0:9  0:9  0:9  1:8  1:8  1:8  1:9  1:8  1:8  0:9  0:9  0:9  1:7  0:9  0:9  0:9  0:9  0:9  0:9  
0:9  0:9  0:9  1:7  0:9  0:9  0:9  8:6  8:8  8:8  8:9  0:9  0:9  0:9  0:9  0:9  0:9  0:9  0:9  0:9  0:9  0:9  1:7  0:9  0:9  0:9  0:9  0:9  0:9  
0:9  0:9  0:9  1:7  0:9  0:9  0:9  9:6  0:9  0:9  9:9  0:9  0:9  0:9  0:9  0:9  0:9  0:9  0:9  0:9  0:9  0:9  1:7  0:9  0:9  0:9  0:9  0:9  0:9  
0:9  0:9  0:9  1:7  0:9  0:9  0:9  9:6  0:9  0:9  9:9  0:9  0:9  0:9  0:9  0:9  0:9  0:9  0:9  0:9  0:9  0:9  1:7  0:9  0:9  0:9  0:9  0:9  0:9  
0:9  0:9  0:9  1:7  1:7  0:9  0:9  9:6  0:9  0:9  9:9  1:7  1:7  1:7  1:7  1:7  1:7  1:7  1:7  1:7  1:7  1:7  1:7  0:9  0:9  0:9  0:9  0:9  0:9  
0:9  0:9  0:9  1:7  1:7  1:7  1:7  9:6  0:9  0:9  9:9  1:7  1:7  1:7  1:7  1:7  1:7  1:7  1:7  1:7  1:7  1:7  1:7  0:9  0:9  0:9  0:9  0:9  0:9  
0:9  0:9  0:9  0:9  0:9  0:9  1:7  9:6  0:9  0:9  9:9  0:9  0:9  0:9  0:9  0:9  0:9  1:7  0:9  0:9  0:9  0:9  0:9  0:9  0:9  0:9  0:9  0:9  0:9  
0:9  0:9  0:9  0:9  0:9  0:9  1:7  9:6  0:9  0:9  9:9  0:9  0:9  0:9  0:9  0:9  0:9  1:7  0:9  0:9  0:9  0:9  0:9  0:9  0:9  0:9  0:9  0:9  0:9  
0:9  0:9  0:9  0:9  0:9  0:9  1:7  9:6  0:9  0:9  9:9  0:9  0:9  0:9  0:9  0:9  0:9  1:7  0:9  0:9  0:9  0:9  0:9  0:9  0:9  0:9  0:9  0:9  0:9  
0:9  0:9  0:9  0:9  0:9  0:9  0:9  0:9  0:9  0:9  0:9  0:9  0:9  0:9  0:9  0:9  0:9  0:9  0:9  0:9  0:9  0:9  0:9  0:9  0:9  0:9  0:9  0:9  0:9  
0:9  0:9  0:9  0:9  0:9  0:9  0:9  0:9  0:9  0:9  0:9  0:9  0:9  0:9  0:9  0:9  0:9  0:9  0:9  0:9  0:9  0:9  0:9  0:9  0:9  0:9  0:9  0:9  0:9  
0:9  0:9  0:9  0:9  0:9  0:9  0:9  0:9  0:9  0:9  0:9  0:9  0:9  0:9  0:9  0:9  0:9  0:9  0:9  0:9  0:9  0:9  0:9  0:9  0:9  0:9  0:9  0:9  0:9  
0:9  0:9  0:9  0:9  0:9  0:9  0:9  0:9  0:9  0:9  0:9  0:9  0:9  0:9  0:9  0:9  0:9  0:9  0:9  0:9  0:9  0:9  0:9  0:9  0:9  0:9  0:9  0:9  0:9  
0:9  0:9  0:9  0:9  0:9  0:9  0:9  0:9  0:9  0:9  0:9  0:9  0:9  0:9  0:9  0:9  0:9  0:9  0:9  0:9  0:9  0:9  0:9  0:9  0:9  0:9  0:9  0:9  0:9  
0:9  0:9  0:9  0:9  0:9  0:9  0:9  0:9  0:9  0:9  0:9  0:9  0:9  0:9  0:9  0:9  0:9  0:9  0:9  0:9  0:9  0:9  0:9  0:9  0:9  0:9  0:9  0:9  0:9  
